##########
#  #     #
#        #
#        #
#   PO   #
#        #
#     X  #
#        #
##########
